aai	liefkozing met de hand	liefkozing
aak	lang en smal vrachtvaartuig	boot	vaartuig	klein schip
aal	aalt	vissoort	mest	gier	mestvocht	beer	paling	consumptievis
aap	zeil	belhamel	wildebras	klein zeil	zoogdier	kwajongen	hoogontwikkeld zoogdier
aas	speelkaart	lokspijs	lokmiddel
agv	als gevolg van
ahw	als het ware
aks	grote bijl	bijl	velbijl	houthakkersbijl
alk	zeevogel	zwart-witte zeevogel
alp	berg
alt	computertoets	zangstem	lage zangstem	toets
apk	periodieke keuring
ara	papegaai	bontgekleurde papegaai
ark	kist voor de thorarollen	vaartuig van Noach	woonschip	triomfboog	boot	vaartuig	woonboot
aso	onaangepast persoon
ast	droogvloer	eest
aub	s.v.p.	alstublieft
bas	laagste geluid	lage muzieklijn	zangstem	lage zangstem	laagste zangstem	snaarinstrument
bel	voorwerp voor geluidssignaal	klingelend voorwerp	bubbel
beo	Aziatische vogel
bes	vrucht	oude vrouw	verlaagde b	b mol	kleine vrucht
big	jong van een wild zwijn	jong van een varken
bof	doffe slag	bons	klanknabootsing	plof	gelukkig toeval	geluk	dikoor	kinderziekte	meevaller
bok	rechthoekige boot	soort boot	soort bier	toestel waarop men schaatsen slijpt	verhoging	gymnastiektoestel	zitplaats voor een koetsier	holhoornig zoogdier	turntoestel	geit	mannelijke geit	mannetje van herten
bos	terrein met bomen
bot	ongenuanceerd	lichaamsdeel	computerrobot	consumptievis	computerprogramma	kortaf	stomp	platvis	hard lichaamsdeel	been	niet scherp
btw	omzetbelasting	overigens	trouwens	belasting
bug	fout in een computerprogramma	programmeerfout
bus	koker	drinkfles	historisch geweer	openbaar vervoer	motorvoertuig	bestelwagen	vervoersmiddel
wit	zeer licht	soort brood	de lichtste kleur	lichte kleur	bleek
moa	uitgestorven loopvogel
oom	nonkel	familielid
vlo	springend insect
nav	naar aanleiding van
kot	hok	bouwwerk in slechte staat	studentenkamer
hit	raak schot	succesvol product	klein paardje	succes	goede slag	succesnummer	treffer	succesvol lied
lap	ronde	stuk stof	stuk textiel
oid	of iets dergelijks
ral	watervogel
mul	zeebarbeel	koning van de haring	gestreepte zeebarbeel	afval van bijen
rif	zandplaat	natuurlijke formatie	ondiep gedeelte in zee	deel van een zeil
kdt	keuken douche toilet
jan	januari
pof	klanknabootsing	bolstaande plooi
sla	salade	groente
muv	uitgezonderd	met uitzondering van
opm	opmerking
eva	en vele andere
kga	klein gevaarlijk afval
ism	in samenwerking met
vin	flipper	zwemvlies	lichaamsdeel van een vis
kat	huisdier	poes
twv	ter waarde van
kin	deel van het gezicht
dal	dieptepunt	decaliter	vallei	laagte	dip
ree	klein hert	hoefdier
vwb	voor wat betreft
kea	papegaaiachtige vogel
vos	sluw persoon	hondachtig roofdier	klein roofdier	roodbruine dagvlinder	zoogdier	bruinrood
ges	verlaagde g	g mol
puf	fut	klanknabootsing	lust	energie	zin
uzi	machinepistool
pom	Surinaamse ovenschotel	ovenschotel
uur	tijdseenheid	tijdstip	tijdsperiode
zkt	zoekt
spa	mineraalwater	plaats in België	bronwater
lom	zeevis
tas	voorwerp om iets in te dragen	kopje	gebruiksvoorwerp
kir	cocktail van wijn
mam	moeder
ros	paard	roodachtig
mem	Hebreeuwse getal 40	Hebreeuwse letter m
sik	kinbaard	geitenbaard
tod	vod	lap
tka	te koop aangeboden
mok	beker
hom	vissensperma	vissperma	zaad van een vis
zus	familielid	vrouwelijk familielid
hes	kledingstuk	mouwloos kledingstuk	bovenkledingstuk
vla	zuivelproduct	dikvloeibaar zuivelproduct
rob	zeehond
ooi	vrouwelijk schaap
kus	zoen	liefkozing
god	opperwezen	vereerd wezen
nok	hoogste gedeelte van een dak	top van een dak	boomtop
tha	te huur aangeboden
mus	zangvogel	tjilpende zangvogel
hen	persoonlijk voornaamwoord	kip
url	webadres	internetadres
zsm	zo spoedig mogelijk
git	delfstof	zwart gesteente
pos	vis
hik	beweging	hikgeluid	klanknabootsing	samentrekking	samentrekking van het middenrif	hikbeweging	geluid
lcd	type beeldscherm
iom	in overleg met
mmv	met medewerking van
uil	nachtvogel	roofvogel
kar	voertuig	wagen	bak
oma	grootmoeder	familielid
jas	kledingstuk
oer	ijzerhoudende grond
gin	soort jenever	alcoholische drank
zkm	zoekt kennismaking met
joh	informele aanspreekvorm
dar	mannetjesbij
dag	tijdsperiode	tijdsaanduiding
kop	hoofd	mok	bovenste
pad	weg	route	amfibie	klein amfibisch dier	smalle weg
reu	mannelijke hond
luw	mild	uit de wind of tegen de wind beschut	zoel	zacht
gsm	telefoon	mobieltje	mobiele telefoon	mobiel
gay	homoseksueel persoon	homo	homoseksueel
sax	blaasinstrument	muziekinstrument
sok	kledingstuk	kous
ram	sterrenbeeld	harde klap	werkgeheugen	mannelijk schaap
rat	knaagdier	zoogdier
obv	op basis van
mbv	met behulp van
rog	platte vis	vis
gin	soort jenever	drank
vis	dier	waterdier
hok	bouwwerk	elementair bouwwerk	verblijfplaats voor dieren	bergplaats
itt	in tegenstelling tot
weg	heen	vertrokken	traject	verdwenen
kca	klein chemisch afval
mol	muziekteken	spion	infiltrant	chemische eenheid	zoogdier	ondergronds dier
hsl	hogesnelheidslijn	spoorlijn
svp	s'il vous plaît	alstublieft
tab	toets op toetsenbord	uitstekend strookje
fut	doorzettingsvermogen	aandrift	energie	zin
das	sjaal	zoogdier	inheems roofdier
gas	chemische toestand	brandstof	pedaal van auto
sof	teleurstelling	mislukking	mislukkeling	flop	tegenvaller
koe	rund	zoogdier
dop	deksel
ipv	in plaats van
pul	kroes	drinkgerei	bierglas	 
kas	constructie in de landbouw	geldvoorraad	gebouw voor gewas
lap	stuk textiel	stuk stof
kor	soort visnet	sleepvisnet
mug	insect
ihb	in het bijzonder
hut	eenvoudig verblijf	vertrek op een schip	houten gebouw
pap	vader	gerecht	brij
jam	muzikale improvisatie	zoet broodbeleg	broodbeleg	confituur
ham	soort vlees	achterbout
lam	schapenjong	geitenjong	jong dier
ram	sterrenbeeld	harde klap	werkgeheugen	mannelijk schaap
tor	kever	insect
mot	ruzie	fijne neerslag	soort nachtvlinder	slaag	nachtelijk insect
ris	rij	hoeveelheid	reeks
ivm	in verband met
ovv	onder vermelding van
jak	rund	langharig rund	mouwloos vest	kledingstuk	bromrund
mei	bloeimaand	maand	bloemenmaand	bloemmaand
kip	vogel
zoz	zie ommezijde
opa	famielielid	grootouder	grootvader
rok	kledingstuk	formeel kostuum	geklede zwarte jas
pup	jonge hond	hondje	hondenjong
ets	drukvorm	grafische techniek
soa	geslachtsziekte
cue	signaal	aanwijzing	aanknopingspunt
plm	circa	ongeveer	plusminus
vet	dik	goed gevuld	gaaf	voedzaam
pak	kostuum	bijeengevoegd geheel	flinke hoeveelheid	last
zee	grote hoeveelheid	watermassa
ivf	reageerbuisbevruchting	in-vitrofertilisatie
jrg	jaargang
aalt	drijfmest	gier	mestvocht	beer
aard	karakter	inborst	wezen
abri	bushokje	rokershokje	haltehuisje	wachthuisje
ader	bloedvat
adhv	aan de hand van
aids	ziekte
amen	dat zij zo
anno	in het jaar
arts	geneeskundige	dokter
asem	adem
auto	motorvoertuig	vervoermiddel	vierwielig motorvoertuig	wagen
baas	hondeneigenaar	leidinggevende	leider	chef
baby	zuigeling	kindje	boreling	pasgeboren kind
bami	noedels	oosters gerecht
bang	benauwd	angstig	bevreesd	bezorgd	zich zorgen makend
bark	groot zeilschip	boomschors
beer	mannetjesvarken	mest	mannelijk varken	groot zoogdier	varken	teddy	zoogdier	knuffelbeest	mestvocht
berg	hoop	stapel	heuvel	grote hoeveelheid
beuk	soort loofboom	loofboom	houtsoort
beul	wreedaard	scherprechter	uitvoerder van vonnissen
bier	alcoholische drank	pils
biet	knolgroente	eetbare wortelknol
bios	filmhuis	filmtheater	plaats waar films worden vertoond
bips	achterwerk	zitvlak	billen	achterste
blei	kleine zoetwatervis	bliek	kolblei
bles	langwerpige witte aftekening	aftekening bij een rund of schaap
blij	vrolijk	verheugd	opgewekt	tevreden
blog	online dagboek	soort website	logboekachtige website
bode	verkondiger	gids	berichtgever	boodschapper
boek	schrijfwerk	bundel bedrukt papier
boer	speelkaart	agrariër	gaslozing uit de maag	elfde kaart uit een kaartspel
bont	harig vel	veelkleurig	gevarieerd
boon	peulvrucht	zaad van vlinderbloemige planten
boos	kwaadaardig	verbolgen	slecht	kwaad	gemeen	met slechte bedoelingen
boot	vaartuig
brak	onsmakelijk	jachthond	met zout water gemengd	ziekjes
brik	gebakken steen	zeilschip	steenpuin	rijtuig	gruis	gammele auto
brol	troep	rotzooi	pulp	rommel
buks	sportgeweer	palmboompje	schietwapen
orka	zwaardwalvis	dolfijn
luit	historisch tokkelinstrument	tokkelinstrument
duif	koerende vogel
muts	hoofddeksel
foor	jaarmarkt	handelsbeurs
maal	keer
drum	slaginstrument	trommelaar	trommel	metalen vat
hoos	wervelwind	visserslaars
vief	rap	vlug	kwiek	levendig
look	kruid	soort plant
giek	rondhout
lama	schaapkameel	boeddhistische leraar	zoogdier	hoefdier
isme	begrip
foef	smoes	uitvlucht
chef	leidinggevende	hoofd	baas	kok
kilt	Schotse rok	Schots kledingstuk
paus	kerkvorst	kerkleider	religieus leider
made	larve
feta	Griekse kaas	witte kaas
noor	schaats	Scandinaviër
onyx	gestreepte halfedelsteen	halfedelsteen	kwartsvariëteit	mineraal
snot	neusslijm	neusvocht
heek	schelvisachtige zeevis	zeesnoek
leng	zoutwatervis	schelvisachtige zoutwatervis
nmbs	spoorwegmaatschappij
fuif	feest
tooi	sieraad	opschik	opsmuk	versiering	versiersel	bloesempracht
jack	jas	jasje
ober	bediende	garçon	kelner
wolf	hondachtig zoogdier	roofdier	zoogdier
pauw	siervogel
incl	inclusief
jaap	messnede	diepe snijwond	snede
feil	gebrek	fout	tekortkoming
kous	soort sok
mama	moeder
muit	vogelkooi
poes	schat	huiskat	huisdier	kat	liefje	vrouwtjeskat	vrouwelijke kat
kaki	dof groenbruin
eend	soort auto	watervogel
pens	maag	orgaanvlees	voormaag	eerste voormaag	buikje
gids	mentor	leermeester	boekje met informatie	iemand die de weg wijst	wegwijzer
knol	plomp paard	paard	verdikking van een plantenstengel	plantendeel	aardappel
daas	steekvlieg	horzel	paardenvlieg	in de war	verdwaasd	brems
wond	huidletsel	letsel	beschadiging
spek	vetweefsel	vet varkensvlees	zacht snoepgoed
juli	zevende maand	hooimaand
gang	tempo	snelheid	tocht	doorloop	tunnel	onderdeel van een maaltijd	verloop
nasi	oosters gerecht
tijk	beschermhoes	geweven stof
vrek	gierigaard
krop	schildkliervergroting	struma	voedselzakje	bolvormige stronk	stronk	slokdarm
zoen	kus
sado	dos-à-dos	tweewielig rijtuig
tors	bovenlichaam	romp van een beeld	torso
rins	zurig	zuur	zuurachtig	friszuur
voer	voedsel	eetwaar	eten voor dieren	voeding	etenswaar
haft	eendagsvlieg
pels	dierenhuid	vacht
zoon	familielid
moes	tot brij gekookte groente of vruchten	gerecht	groente	soort moes	hoeveelheid moes
prof	hoogleraar	beroepssporter
veem	opslagplaats	pakhuis	onderneming voor goederenopslag
worm	klein dier zonder poten
zeel	draagband
file	lange rij	bestand	Met Nederlandse uitspraak	Met Engelse uitspraak	computerbestand	rij
mier	in kolonies levend insect	insect
geit	vrouwelijk hert	melkgevend hoefdier	zoogdier
pest	de Zwarte Dood	zeer besmettelijke ziekte
skai	kunstleer
vink	zangvogel	vogel
vlnr	leesrichting	van links naar rechts
clou	hoogtepunt	climax
obus	projectiel	granaat
luik	beweegbaar schot	paneel van een schilderij	paneel
eest	ast	droogvloer
snip	snifferig	loopvogel met lange snavel	verkouden	honderdguldenbiljet
halo	lichtkring	stralenkrans	aureool
raaf	grote zwarte vogel
kist	grote reiskoffer	opbergmeubel	opbergbak	vliegtuig	soldatenschoen	koffer
iglo	sneeuwhut	ijshut
club	vereniging	groep personen	golfstok	uitgaansgelegenheid
wijn	drank
walg	afkeer
fuut	watervogel
tuil	boeket	trosvormige bloeiwijze	bloeiwijze
sijs	vinkachtige vogel
zoel	mild	broeierig	zoet	aangenaam ruikend	zacht
stut	turnoefening	steun	steunbalk
juni	maand	rozenmaand	zomermaand
imam	islamitische voorganger	islamitisch leider	sjiitisch leider
slem	bridgeterm
week	tijdseenheid	periode	vervloeiend	teer	tijdsaanduiding	zacht
eter	gast	tafelgast
dief	crimineel
vijg	klap	vrucht
koop	aanschaf	consumptiegoed	wat te koop of gekocht is	handeling	duif	aankoop	duif die te koop is	financiële transactie	gekochte
eten	maaltijd	voedsel	spijs	maal
gems	klipgeit	berggeit	zoogdier
stip	plekje	rondje	rond teken	punt
erwt	peulvrucht	groente
pier	aardworm	ringworm	golfbreker	regenworm
vuig	verwerpelijk	gemeen	verdorven
mond	deel van het gezicht
kiep	doelverdediger
olie	zwart goud	vette vloeistof	vloeistof	brandstof
mais	graan	graangewas
roos	plant	doelwit	doelpunt	bloem
rong	steunbalk
meel	poeder	graanproduct
kiek	fotootje	foto	kuiken
wulp	vogel
peur	vislijn
joch	knaap
kees	soort hond
spon	houten stop
hoop	stapel	berg	menigte
glos	aantekening
riem	hoeveelheid papier	gordel	band	roeispaan	ceintuur
koek	lekkernij
hemd	kledingstuk
wouw	vogel	roofvogel
hart	orgaan	midden	vlees	afbeelding	tijdstip	innerlijk	rikketik	afbeelding van een hart	middelpunt van een gebied	binnenste deel	lichaamsdeel	wezen	kernactiviteit	spil	draaischijf	midden van een periode	vlees van de hartspier van dieren	spil of kerngroep	corebusiness	kunsthart	gemoed	middelpunt	spier	borst	deel	gevoel	binnenste	voorstelling	tikker	holle spier in de borstholte	prothese	centrum	kern	hartstreek	essentie	hartje	punt	putje
tipi	tent
taxi	vervoersmiddel
dolk	steekwapen	kort steekwapen
noga	zoete lekkernij	snoepgoed	lekkernij
geut	scheut
hoed	hoofddeksel	bovenkant van een paddenstoel
ecru	crèmekleurig	roomwit	lichte kleur	gebroken wit
sekt	wijnsoort	mousserende wijn
slof	gebak	pantoffel	slordig	langwerpig gebak
lame	garen met metaalkleurige draad	soort garen	weefsel met metaalkleurige draad
chip	microprocessor	fiche	schijfje	geïntegreerde schakeling	transponder
ibis	watervogel	vogel
sext	interval van zes tonen	muzikale interval	getijdengebed
soek	marktplaats	overdekte marktplaats
mono	enkel
wauw	uitroep
ruin	gecastreerde hengst
neet	luizenei
reep	strook	rechthoekig deel
leek	iemand zonder vakkennis
kers	vrucht	houtsoort	kleine steenvrucht
munt	betaalmiddel	valuta	geldstuk	kruid	plant	smaak	penning
hert	zoogdier
gnoe	Afrikaans zoogdier	hertenpaard	zoogdier	wildebeest	hertenstier
pots	streek	grap
kaan	uitgebraden vet
oase	vruchtbare plek
knak	breuk	hoekige vorm	hoek	klanknabootsing
pink	vinger	kleinste vinger
taks	belasting
zout	pekel	conserveringsmiddel	smaakmaker	hartig	smaak
heli	luchtvaartuig
mees	zangvogel	vogel
soep	gerecht
vlot	aan de gang	ongedwongen	soepel verlopend	in beweging	snel	primitief vaartuig
kuit	lichaamsdeel
mijt	hooischelf	hooistapel	middeleeuws muntstuk	klein diertje
hesp	lichaamsdeel	achterbout	dij	ham	hamsoort
peuk	sigaret	rookartikel
peer	vrucht	gloeilamp	fruit
polk	slaapplaats	nest
jaar	tijdsaanduiding	periode
smid	metaalbewerker	beroep
nors	nurks	chagrijnig	slechtgehumeurd	onvriendelijk
melk	drank	voedingsmiddel
krab	kreeftachtige	schaaldier
hifi	natuurgetrouw weergaveapparaat	natuurgetrouwe weergave	weergaveapparatuur
trui	kledingstuk
huis	woning	gebouw	woonruimte
valk	roofvogel
haan	mannelijk dier	vogel
dodo	uitgestorven diersoort	vogelsoort
wesp	insect
tolk	vertaler
vork	eetgerei
lans	steekwapen
gors	kwelder	zangvogel	aangeslibd land	vogel
zege	triomf	overwinning
prei	groente
ezel	schilderswerktuig	zoogdier
soap	televisieserie
malt	soort whisky	soort bier	koffiesurrogaat
tram	vervoermiddel
coma	bewusteloosheid
kerk	gebouw	religieus genootschap
maan	hemellichaam	satelliet
tank	reservoir	gepantserd voertuig
egel	zoogdier met stekels	zoogdier
welp	jonge scout	jong dier
kwal	zeedier
pina	açaipalm	podosiripalm
oryx	soort antilope	spiesbok	antilope
excl	exclusief
doek	stuk stof
soes	gebakje
gesp	sluiting
faro	zoet Brussels bier
teef	vrouwelijke hond	vrouwelijk dier
tuba	blaasinstrument
gres	zandsteen
noot	annotatie	harde boomvrucht	kanttekening
quad	motor met vier wielen
kift	jaloezie	afgunst
riks	rijksdaalder
page	dienaar van een ridder	grote, kleurrijke vlinder
kauw	zwarte vogel	kraaiachtige vogel	vogel
mode	hippe kledij	voorbijgaand gebruik
wees	kind zonder ouders
wild	ongerept	onbeheerst	chaotisch	ruig	niet beregeld	ongecontroleerd	in de natuur
rups	lasnaad	kermisattractie	vlinderlarve
doei	groet	dag	afscheidsgroet
hout	natuurlijk materiaal	materiaal
noon	getijdengebed
dino	reptiel	uitgestorven reptiel
stag	kabel op een schip	kabel
kerf	insnijding	snede
dame	schaakstuk	vrouw
wadi	droogstaand rivierdal
rose	wijnsoort
fret	dwarsbalkje op een instrument	zoogdier	marterachtig roofdier	handboortje	dwarsbalkje
fond	hoofdzaak	geur	basis	afstand	achtergrond in figuurlijke zin	wezen	vermogen	basisgeur van een parfum	gistbodem	lange afstand in de duivensport	bodem	soort fond	sterk geconcentreerde bouillon	grondslag	achtergrond	uithoudingsvermogen	basisgeur	grond	lange afstand in de atletiek of wielersport	onderste laag	kern	essentie	laag	bouillon	lange afstand
dode	overledene	gestorvene
zine	tijdschrift
jurk	kledingstuk	japon
wrat	knobbeltje	huiduitwas
zalm	roze kleur	trekvis	vis
luik	beweegbaar schot	paneel van een schilderij
euro	munteenheid	muntstuk
luis	parasitair insect	insect
gong	slaginstrument
peen	wortel
knie	gewricht
teek	spinachtige parasiet	spinachtig diertje
spin	snelbinder	dier met acht poten
gent	mannetjesgans	ganzerik
hoen	soort vogel	kip
oxer	hindernis bij ruitersport
helm	beschermend hoofddeksel	duinplant
wiel	ronde poel achter een dijk	onderdeel van een auto	rad	onderdeel van een fiets
pony	froufrou	haarstijl	klein paard
tong	spraakorgaan	platvis
paap	rooms-katholieke	geestelijke
geep	zeevis
eeuw	tijdseenheid	periode
ever	zwijn	wildzwijn	wild zwijn
mate	Zuid-Amerikaanse kruidenthee	paraguaythee
gouw	landstreek	deelgebied	provincie
sake	rijstwijn	Japanse rijstwijn	drank
krik	hefwerktuig	vijzel
hond	huisdier
pijn	leed	den	smart
pons	brug van Varol	perforator	gereedschap om gaten te maken	hersenverbinding
rata	evenredig deel
zona	gordelroos
haas	zoogdier	bang persoon
yoga	lichaamsoefeningen	hindoeïstische filosofie
roek	kraaiachtige vogel	vogel
doge	staatshoofd van een stadsrepubliek	staatshoofd
teut	beschonken	dronken	aangeschoten	onder invloed
jive	Latijns-Amerikaanse stijldans	dans
kruk	uitstekend deel aan een as	zitmeubel	handgreep van een auto	hulpmiddel bij het lopen
mail	elektronisch bericht	communicatiemiddel
rund	herkauwend zoogdier	zoogdier
opoe	een oude vrouw	grootmoeder	oma
lino	drukvorm	grafische techniek
lork	lariks	naaldboom
koet	zwarte vogel met witte snavel	waterkip	vogel
zeem	lap om mee schoon te maken	lap
vest	kledingstuk	stadsgracht
sire	aanspreektitel
houw	krachtige slag	inkerving	slag
hulp	bijstand	ondersteuning
guts	beitel	lef	holle beitel
wurm	klein kind	dier
kaak	wang	koek	deel van de schedel	deel van het gezicht
drop	zwart snoepgoed	soort snoep
fier	statig	trots	hooghartig	hoogmoedig	hovaardig
muis	knaagdier	klein zoogider	accessoire bij een computer	deel van de hand
kiel	kledingstuk	bodembalk van een schip	deel van een schip
kapo	opzichter	kampbewaker
kalf	jong rund	jong dier
sari	Indiaas gewaad	soort gewaad
vijs	schroef
poon	knorhaan	zeehaan	zeilend vrachtschip
omen	voorteken
desa	bestuurseenheid in Indonesië	bestuurseenheid	dorpsgemeenschap
room	zuivelproducht
wang	zijkant	deel van het gezicht	lichaamsdeel
fado	Portugese muziekstijl	Portugees volkslied
gans	grote watervogel	volkomen	geheel	vogel
gojs	niet-joods
gaai	mikvogel	kraaiachtige vogel	vogel
pauk	slaginstrument	keteltrom
pers	oosters tapijt	raskat	drukmachine
tapa	Spaans hapje	hapje
menu	spijskaart	lijst van opties
peul	soort erwt
stol	brood	luxe krentenbrood
most	nog niet  gegist sap
slab	morsdoek	strook lood
goud	kostbaar metaal	edelmetaal
mest	dierenpoep	bodemvoeding	beestenpoep
huif	kap	valkenkap	valkenkapje	overkapping	overkapping op vervoermiddelen
mica	glasachtig mineraal	mineraal
poli	spreekuur
loge	gast	slaper
muur	deel van een gebouw	barrière
cake	gebak
thee	drank	warme drank van theeblaadjes	blaadjes van de theeplant
mouw	deel van een kledingstuk
yogi	yogaleermeester
cape	schoudermantel	kledingstuk	mouwloze schoudermantel
hijs	klus	kraan	werktuig
klif	steile rotswand	zandige hoogte	rotswand
lori	aapachtig nachtdier	halfaap	papegaai	felgekleurde papegaai
ruif	voederrek
lynx	zoogdier	sterrenbeeld	katachtig zoogdier
haai	roofvis
kaas	zuivelproduct
slak	weekdier	traag persoon
gaap	geeuw
gier	aalt	roofvogel	aaseter	drijfmest	mestvocht	aasetende vogel
date	afspraakje	afspraak
knul	knaap	jongen	joch
zeug	vrouwelijk varken	vrouwelijk zwijn
hobo	blaasinstrument	houten blaasinstrument
kool	brandstof	groente
sawa	rijstveld	nat rijstveld
sten	schietwapen
kano	boot	kleine boot	langwerpige gevulde koek
yank	Noord-Amerikaan	Amerikaan
palm	deel van de hand	tropische boom
harp	groot tokkelinstrument	snareninstrument	tokkelinstrument	muziekinstrument
aaien	licht aanraken	in contact komen	aanraken
abeel	zilverpopulier	soort populier	populier
acces	toegang
actie	handeling	optreden
acuut	dringend	hoogstdringend	plotseling	plotseling optredend	urgent	spoedeisend
adder	gluiperd	slang
adieu	afscheid	vaarwel	doei	afscheidsgroet	tot ziens	groet	dag	doeg
adios	tot weerziens	doei	tot ziens	ajuus	dag	adieu
agent	vertegenwoordiger	eenheid	politievrouw	medewerker bij geheime dienst	diender	politieman
akela	welpenleider
album	stripboek
allee	vooruit	kom op	brede weg	komaan
alpen	bergketen in Europa	bergketen
alver	moertje	alfje	zilverkleurig karpertje
ampul	injectievloeistofbuisje	flesje voor vloeistof	buikig kruikje	kannetje	flacon
amuse	mondpleziertje	mondvermaakje	hapje
anijs	specerij	schermbloemige plant
anker	rotor	sterke haak	deel van een uurwerk	houvast	referentiepunt	voorwerp	gedeelte van een skilift	voorwerp om een schip stil te leggen	nieuwslezer
anode	positieve elektrode
appel	vrucht	ronde vrucht	houtsoort	hoger beroep	het terugroepen van een hond	fruitsoort	boomsoort	verzoek	rechtshandeling
april	grasmaand	vierde maand	paasmaand	eiermaand
arend	adelaar	grote roofvogel
argus	brakwatervis	nauwlettend toezichthouder
armee	bewapende troep
asbak	rokersbenodigdheid	voorwerp voor peuken	iemand die veel rookt
avond	soiree	deel van de dag voor de nacht	dagdeel
azijn	zure vloeistof
azuur	hemelsblauw
baard	gezichtsbeharing	maishaar	haar op kin en wangen	balein
baars	riviervis	vis	consumptievis
bacil	staafbacterie	bacterie
bagel	ringvormig broodje
bahco	verstelbare steeksleutel	Engelse sleutel
balts	hofmakerij	paringsgedrag
banjo	tokkelinstrument
baron	adellijke man	vrijheer
basic	elementair
baton	dirigeerstok	majorettestok	dirigeerstokje
beest	dier	wild dier
beleg	gerecht op brood	omsingeling	toespijs
bever	groot knaagdier	kleine scout
bezem	huishoudelijk voorwerp	voorwerp om mee te vegen
bidet	lage wasbak	billenbadje
bidon	drinkbus	afsluitbare drinkfles
bigot	schijnheilig	fanatiekeling	fanatiek religieus persoon	schijnvroom
bizon	groot rund	wild rund
blaag	brutaal iemand	snotneus	deugniet	jong	kwajongen
blaar	blaas	blaas onder de huid	bles	witte aftekening
blase	pedant	zelfingenomen	door verwenning verveeld
bliek	kolblei	blei	jonge haring	kleine zoetwatervis
bloem	fijn gezift meel	deel van een plant	meel
bolus	Zeeuws koffiebroodje
bompa	opa	grootvader
bonje	mot	onenigheid	ruzie
boord	plank	plank om iets op te zetten	kraag van een overhemd	opstaande scheepswand	afwerking van een opening	kraag	rand
boter	gekarnde melkroom	zuivelproduct
boxer	onderbroek	hondenras
braam	fruitsoort	najaarsvrucht
brems	steekvlieg	daas	horzel	paardenvlieg
breuk	fractuur	scheur	schade	getal	verandering
broek	drasland	stuk moerassig land	pantalon	kledingstuk
broer	bloedverwant	familielid
brood	voedsel	voedingsmiddel
broom	chemisch element
bruid	verloofde	aanstaande echtgenote	vrouw op haar trouwdag
buggy	wandelwagen	wandelwagen voor peuters
buret	glazen buis
conga	hoge trom
cider	drank van vergist vruchtensap	alcoholische drank
woerd	mannetjeseend
joule	eenheid van energie
ijsje	koude lekkernij
kruit	ontplofbaar poeder
lymfe	lichaamsvocht
opaak	onduidelijk	ondoorschijnend	dekkend	obscuur	niet doorzichtig	ondoorzichtig	moeilijk te begrijpen
gekko	reptiel	soort hagedis
prauw	soort boot
jambe	versvoet
oehoe	ooruil	arenduil	grote uil
skiff	kleine roeiboot
hamel	gecastreerde ram
welsh	Keltische taal
octet	byte	muziekensemble	muziekgezelschap
mango	vrucht	tropische steenvrucht
piano	toetsinstrument	op zachte toon	klavierinstrument
zweer	etterende ontsteking
gevel	buitenmuur
zebra	gestreept zoogdier	gestreept dier
leeuw	sterrenbeeld	groot roofdier
okapi	Afrikaans zoogdier	zoogdier
pruim	fruitsoort	steenvrucht
laars	schoeisel	hoog schoeisel
varen	plant	drijven	door water gaan
fries	gordijn	sierband	taal
ruien	kalen	veren of haren verliezen
kuras	borstharnas	harnas
vaars	jonge koe
vogel	gevleugeld dier 
loner	eenzaat	individualist	einzelgänger	solist	solitair	kluizenaar
forel	zalmachtige vis	zoetwatervis
vlees	spierweefsel	voedsel
wants	keverachtig insect
digid	inlogcode voor overheidsinstellingen	inlogsysteem voor overheidsdiensten
draak	monsterachtig fabeldier	iets indrukwekkends	fabeldier	smakeloos kunstwerk
lavet	waskuipje
golem	joodse sagenfiguur
jicht	gewrichtsaandoening
sedan	soort auto
kiosk	infozuil	winkeltje
sitar	luitachtig snaarinstrument	snaarinstrument
muzak	achtergrondmuziek	muziekbehang
oeros	rund uit de prehistorie	uitgestorven rund
gebak	lekkernij	gebakken lekkernij
kaars	sfeervolle verlichting	wasstaaf
mazen	breiwerk herstellen
gezin	familie	huishouden
cadet	kleine zeilboot	officier in opleiding
sabel	categorie bij het schermen	metselaarsgereedschap	schermwapen	steekwapen	soort marter
edict	verordening	ordinantie	overheidsbesluit	uitgevaardigd besluit
risee	iemand om wie iedereen lacht
libel	insect dat bij het water leeft	vliegend insect
spons	primitief meercellig dier	voorwerp om mee schoon te maken
steeg	smalle weg
kajak	kleine, gesloten kano	kano
expat	iemand die in het buitenland werkt
vaart	vooruitgang	waterweg	tempo	snelheid	bootreis	kanaal	hoog tempo	hoge snelheid
opper	hooischelf	stapel gedroogd gras	schuilplaats voor een schip
pegel	ijskegel
folie	dwaze bui	verpakkingsmateriaal	dwaze handeling
manga	Japans stripverhaal	tropische vrucht	mango
prime	eenklank	grondtoon	muzikale interval
lakei	bediende
spijs	voedsel	vruchtenmoes	gerecht	eetwaar	voedingsmiddel
zomer	jaargetijde	seizoen	bloeitijd	bloeiperiode
sinas	limonade	sinaasappellimonade
rabbi	synagogeleider	rabbijn	religieus leider
lunch	middagmaal	middageten	middagmaaltijd
geuze	biersoort
pasta	deegwaar	Italiaans deegwaar
tjalk	zeilschip
lysol	ontsmettingsmiddel	desinfectiemiddel
conge	ontslag
ouwel	sluitzegel voor brieven	eetpapier	hostie	ongeconsacreerde hostie
leeuw	groot katachtig roofdier	sterrenbeeld
plens	guts	gulp
stola	sjaal
galon	belegsel	bies	boordsel
linze	zaad	rond, plat zaadje
dweil	schoonmaakattribuut	lap voor de vloer
hydra	meerkoppig monster	fabeldier
pinda	noot	nootje	peulvrucht
rumba	Latijns-Amerikaanse muziek	Latijns-Amerikaanse dans
gerst	graangewas
dadel	zuidvrucht
rodeo	gevaarlijke rit	cowboywedstrijd
volta	wending	keerpunt
krant	nieuwsmedium	nieuwsblad	gazet
nanny	kinderoppas	oppas	babysitter
galei	roeivaartuig
vazal	leenman
tenor	zangstem	partij in een muziekstuk
klomp	homp	houten schoen	kluit
ijzel	weersomstandigheid
largo	zeer langzaam	langzaam gespeeld muziekstuk
tonic	frisdrank	bittere frisdrank
cello	strijkinstrument	groot strijkinstrument
puree	fijngestampt voedsel	gerecht	fijngestampte aardappelen
maker	schepper
kluns	knoeier	onhandig persoon	prutser
flink	behoorlijk	fors	vrij groot
sater	mythisch wezen	wezen met bokkenpoten
rebus	woordraadsel
tsaar	slavische vorst	vorst
kriek	morel	soort bier	zure kers
gagel	inheemse struik	aromatische struik
speer	werpwapen	steekwapen
stier	mannelijk dier	mannelijk rund	sterrenbeeld
praam	klem voor een paard	type binnenschip	binnenschip
pasen	feestdag	Christelijke feestdag
imago	reputatie	volwassen insect
meeuw	zeevogel
kwark	zuivelproducht	plattekaas	zachte witte kaas
spion	inlichtingenofficier	kijkspiegel	spiegeltje bij een raam
oever	waterkant
dwerg	klein fictief wezen	kleine diersoort	soort ster
druif	vrucht	vrucht van de wijnstok
toque	ronde baret	koksmuts
zever	gepraat	nonsens	onzin	kletspraat
tahoe	bonenkaas	sojaproduct	sojakaas	tofoe
panty	onderkledingstuk	nylons
hozen	water uit een boot scheppen	stortregenen	regenen	uitgieten
kluut	soort waadvogel
snoek	roofvis
nadir	laagste punt	voetpunt
coach	autobus	begeleider	reisbus	trainer	touringbus	oefenmeester
sushi	Japans gerecht
kwint	vijfde toon	muzikaal interval
klerk	kantoorbediende
spint	soort mijt	oude inhoudsmaat	jonge houtlaag
tarwe	graangewas
sloep	kleine boot
panda	bamboebeer	beer uit West-China
kokos	klapperboom	steenvrucht	klapper
frank	onbeschroomd	munteenheid	muntstuk
temen	lijmerig praten
limbo	voorgeborchte	acrobatische dans
proza	niet-rijmende taal
fluit	signaal	blaasinstrument	instrument
peper	specerij	keukenkruid
trens	paardenbit
rekel	brutale deugniet
pater	geestelijke
larve	levensfase van insecten
oppas	babysitter
litho	steendruk
etser	kunstenaar
opium	verdovend middel
helix	schroeflijn
tauge	sojascheut	Chinese groente	groente
kapok	vulmiddel voor kussens
sulky	renwagen	renwagentje
gilet	mouwloos vest
haiku	Japanse dichtvorm	kort gedicht
motto	kenspreuk
silex	vuursteen	gesteente
dingo	wilde hond
radja	Indiase vorst	vorst
facie	gezicht
hoest	kuch	explosieve uitademing
kroos	drijvend waterplantje	waterplant
koala	Australisch buideldier
haver	graangewas
vedel	historisch strijkinstrument
aalbes	vrucht
aalput	verzamelplek voor mestvocht
aardig	sympathiek	vriendelijk	innemend	lief
abacus	telraam
abject	verwerpelijk	verachtelijk
absent	afwezig
absint	kruidenlikeur	likeur
acteur	toneelspeler
actief	handelend	bedrijvend	in dienst	in bedrijf	werkzaam	naarstig	bedrijvig	werkzaamheden verrichtend	arbeidzaam	ingeschakeld	vol beweging	doende	tewerkgesteld	ijverig	bezig
afasie	taalstoornis
afslag	verandering van richting	afrit	zijweg	aftakking
aftrap	opening	start	kick-off
agenda	planning	jaaroverzicht	lijst van te bespreken punten	tijdsindeling
agnost	iemand die niet weet of er een hogere macht is
airbag	botsballon	luchtzak	zichzelf opblazende zak	stootkussen
akelig	schrikwekkend	vreeswekkend	walgelijk	ijzingwekkend	onguur	weerzinwekkend	eng	griezelig	naar	angstaanjagend	beangstigend	luguber	afschuwelijk	macaber	onaangenaam	afstotelijk	vreselijk
albino	witharige
alleen	enkel	uitsluitend	eenzaam	zonder toezicht	zonder hulp	op zichzelf	zonder gezelschap	verlaten	slechts	afgezonderd	apart	geïsoleerd
alpino	baret
amoebe	eencellig organisme	slijmdiertje
ananas	vrucht	tropische vrucht	fruit
arduin	kolenkalksteen	blauwsteen	kalksteen	hardsteen	blauwgrijze kalksteen	blauwe hardsteen
armada	grote oorlogsvloot
arrive	iemand met status
asceet	sober levend persoon
asfalt	wegdek
ataxie	zenuwaandoening	stoornis tussen het zenuwstelsel en de spieren
augurk	soort komkommer	groente
auteur	kunstenaar	schrijver
axiaal	de as volgend
badpak	zwemkleding
bakker	broodverkoper
balken	iaën
ballet	danskunst
banaan	kromme vrucht	tropische vrucht	gele vrucht	fruit
banket	gebak	feestelijke maaltijd	zoet gebak
barzoi	hazewind	windhond	Russische windhond
basalt	vulkanisch gesteente
basset	jachthond
batten	het wicket verdedigen
bauwen	blaffend roepen
beagle	hondenras	jachthond
beamer	videoprojector	projector	digitale projector
beitel	gereedschap
beller	telefoneerder
bengel	stout kind
beslag	hang- en sluitwerk	mengsel van meel
bestek	eetgerei
beulen	werken	zwoegen
biceps	opperarmspier	spierbal
bikini	tweedelige badkleding	badkleding
bikkel	doorzetter
bikken	hakken
bissen	een jaar overdoen	doubleren	dubbelen	zittenblijven	overdoen
blaten	mekkeren	het geluid van een schaap maken	het geluid van een geit maken
bleren	janken	hard huilen
bobijn	spoel	garenklos	filmspoel	klos
boeket	ruiker	verzameling bloemen
boemel	stoptrein	kroegentocht
boilie	visaas voor karpers	visaas	karperaas
bokaal	deel van een saxofoon	wedstrijdbeker	sierbeker op een voet	glazen pot
boktor	kever	houtetende kever
bolder	paaltje waaraan een schip wordt vastgelegd
boleet	vlezige paddenstoel
bolide	raceauto	snelle dure auto	grote meteoriet
bonbon	kleine lekkernij	chocolaatje	chocolaatje met vulling	praline
bonobo	dwergchimpansee	kleine mensaap	aap
bosbes	vrucht	blauwe vrucht
bosuil	roofvogel
botter	vissersboot	Hollandse vissersboot
brasem	karperachtige vis	zoetwatervis
bretel	draagband
briket	samengeperste brandstof
bubbel	luchtbel	gasbel	zeepbel
buffel	bizon	soort rund
buffet	maaltijd	zelfbedienmaaltijd
buldog	hondenras	koppige vechter	Brits hondenras
bundel	bos	telefoonabonnement	samengebonden zaken	pak
burcht	versterkt kasteel	ondergronds dierenverblijf	kasteel
krokus	voorjaarsbloem	irisachtige bloem
klever	plakker	sticker
pochet	fijn zakdoekje	zakdoekje	lefdoekje
kapoen	gecastreerde haan
schaap	kuddedier	zoogdier
sukkel	stumperd	klungel	kluns
roepia	Indonesische munteenheid	munteenheid
pyjama	nachtkleding
kiepen	doen kantelen	kantelen	omslaan	omvallen
vlegel	deugniet	vlerk	kwajongen
jaguar	katachtig roofdier	zoogdier
rappel	afdaling	terugroeping	verticale afdaling
portee	reikwijdte	draagwijdte
zoeloe	taal
derrie	iets vies	vuil
harten	speelkaart
foelie	specerij
mergel	zachte kalksteen	klei met kalk	gesteente
eigeel	dooier
reiger	vogel met lange nek	vogel
lemmet	kling	gedeelte van een mes
wortel	afkomst	deel van een plant	peen	grondvorm	oorsprong	herkomst
muffin	gebak	cakeje
ersatz	surrogaat	vervanger	vervangingsmiddel
octaaf	interval van acht	eerste deel van een sonnet	muzikale interval	achtdaagse periode
menuet	statige dans	drieledige muzikale compositie
knecht	bediende	ondergeschikte
sneven	ten onder gaan	sneuvelen
decade	periode van tien dagen	reeks van tien boeken
kreeft	schaaldier met scharen	teken van de dierenriem	sterrenbeeld
juweel	sieraad	geslepen steen	waardevol voorwerp	prachtexemplaar
hybris	hoogmoed	overmoed
pinken	knipogen	flonkeren	flikkeren	knipperen
myopie	bijziendheid
stoepa	boeddhistisch heiligdom	heiligdom
viltje	onderlegger	onderzetter voor glazen	bierkaartje
sintel	rest	uitgebrand stuk steenkool	kolenslak	slak	overblijfsel
chador	gewaad	islamitisch zwart gewaad
kijker	optisch instrument	oog
ragout	gestoofd gerecht
zoetje	lieverd	koosnaam	schatje
doctor	titel	afgestudeerde	graad	gepromoveerde
pastor	kerkelijke functionaris
haring	zeevis	zilvergrijze zeevis
gerant	horecabedrijfsleider
rommel	troep	janboel	puinzooi	puinhoop	zootje	zooi	bende	pulp	warboel
triton	Griekse zeegod	zeegod	maan van Neptunus
maatje	vriendje	kameraadje	vriend	buddy
yoruba	taal
redder	verlosser	helper
cheeta	jachtluipaard
remake	nieuwe versie
poesta	grasvlakte in Hongarije
ceylon	theesoort
ploert	schurk	hufter	schoft
kwibus	vreemde kwast	zot	dwaas
subiet	onmiddellijk	direct	terstond	meteen	dadelijk	ogenblikkelijk
claris	kloosterzuster	aanhanger van kloosterorde
piloot	autocoureur	vliegtuigbestuurder	vliegenier
vorsen	onderzoek doen	speuren	zoeken	iets onderzoeken	onderzoeken
pappen	met lijm besmeren
jutter	strandrolstoel	verzamelaar
factor	variabele	achterliggende variabele	bijdragende omstandigheid
jacket	papieren boekomslag	porseleinen kroon	opblaasbaar duikvest
waffel	bek	mond	snater
sproet	huidvlekje
oudere	senior	bejaarde
gierst	graangewas
vorser	onderzoeker	wetenschapper
putter	zangvogel	golfclub	distelvink
cohort	legereenheid	groep vergelijkbare mensen
zoomen	vergroten of verkleinen
safari	reis om wild te zien
keuter	jong kind
douche	stortbad	badkamervoorziening
kobold	aardmannetje	kabouter
discus	kraakbeenschijf	werpschijf	nectarklier
roeien	varen
rijven	harken
trauma	wond	verwonding	lichamelijke verwonding	letsel	psychisch letsel
koraal	kolonie poliepen	roodroze kleur
walrus	groot zeezoogdier
pyloon	gedenkzuil	brugpijler	hoogspanningsmast	hoge draagconstructie	Egyptisch poortgebouw	zendmast	elektriciteitsmast
kinine	antimalariamiddel	koortswerende stof	geneesmiddel
koffie	warme drank
livrei	uniform voor huisbedienden
moment	tijdstip	ogenblik
merrie	vrouwelijk paard	vrouwelijke ezel
rammel	mechanisch klokkenspel	slaag
yankee	Noord-Amerikaan	Amerikaan
dromer	idealist
citaat	aanhaling
detail	bijzonderheid	deel
suffix	achtervoegsel
pummel	lomperd
maniok	broodwortel	cassave	tropisch gewas	wortelknol	tapioca	cassavemeel
smient	grondeleend
nimbus	aureool	lichtkrans	wolkentype
spanne	periode
zuster	verpleegster	zus	vrouwelijke medegelovige	verpleegkundige	vrouw die lid is van een geestelijke orde	vrouwelijke gelijkgezinde
topaas	edelsteen	mineraal
tijger	dierenriemteken	man	grote katachtige met strepen	afbeelding	kat	zoogdier	beeld	Chinees dierenriemteken	knuffel	knuffeldier	uitgestorven buideldier	buidelwolf	wortelknol	strijdbare man	land	regio	gebied met snel groeiende economie
tantra	geschrift	Oud-Indisch geschrift	leer	spirituele leer
kubist	modernistisch kunstenaar
dolmen	prehistorisch grafmonument	grafmonument
spasme	hevige spierkramp	kramp
viking	Noorman
spatel	kookgerei
tonica	grondtoon
koorts	ziektesymptoom
heraut	vertegenwoordiger	verkondiger	aankondiger	boodschapper
effect	uitwerking	gevolg	resultaat
kelner	ober
tronie	gezicht
spatie	ruimte tussen woorden	tussenruimte
muskus	sterk ruikende geurstof
fluide	veranderlijk	soepel	vloeistofachtig
perzik	fruit	steenvrucht
joehoe	hé daar	uitroep
tarbot	schijfvormige platvis	platvis
viskom	aquarium
griend	rijshout	soort dolfijn
fohnen	drogen
fideel	trouwhartig	loyaal	trouw
pineut	slachtoffer
dengue	tropische ziekte
oortje	in-earkoptelefoon	handvatje van een kopje
radijs	groente
hollen	rennen
master	titel	veteraan	afgestudeerde	bronkopie	opleiding	origineel bestand
censor	criticus	beoordelaar	Romeins magistraat
kapper	coiffeur
gondel	sloep	Venetiaanse sloep	cabine aan een kabelbaan
dissel	verbindingsstuk voor aanhangwagens	soort bijl
kiften	kibbelen	ruziemaken	bekvechten
verbum	woordsoort	werkwoord
insect	dier met zes poten	klein dier
papaja	meloenboom
varken	zoogdier	tam zoogdier
prefix	voorvoegsel
genese	wording
riksja	rijtuig	oosters rijtuig
garcon	ober
epoque	periode voor de Eerste Wereldoorlog	tijdvak	tijdperk
marter	slank bruin roofdier	klein roofdier
lillen	trillen	trillend bewegen	levendig of bewogen zijn
toetje	dessert	nagerecht	gezichtje
cirrus	pluimachtige wolksoort
aalglad	niet te vangen	gelikt	erg glibberig	zonder enige hobbel of rimpel	ongrijpbaar
aardbei	zomerkoninkje	fruit	vrucht
aasgier	soort vogel
acoliet	misdienaar
actrice	toneelspeelster
actueel	van ogenblikkelijk belang	van deze tijd	tegenwoordig	huidig	up-to-date	bij de tijd	hedendaags	eigentijds
adelaar	soort vogel	arend
adhesie	aankleving	aantrekkingskracht	aantrekkingskracht tussen moleculen
affreus	foeilelijk	lelijk	afschuwelijk	vreselijk	verschrikkelijk
affront	hoon	belediging	smaad
afmaker	winnende actie	rake opmerking
afvaren	vertrekken
afwezig	niet ter plaatse	absent
akkoord	goedkeuring	goedgekeurd	instemming	harmonie	goed	oké	overeenkomst	in orde
alcohol	ethanol	drank
alledag	dagelijks
althobo	blaasinstrument
amandel	klier	steenvrucht
amarant	rode kleurstof	sierplant
amateur	liefhebber	beoefenaar	hobbyist	prutser	beoefenaar uit liefhebberij	knoeier
amfibie	voertuig dat rijdt en vaart	tweeslachtig dier
amnesie	geheugenverlies
analist	laboratoriummedewerker
anemoon	bloem
angelus	katholiek gebed
angstig	bangerig	bangetjes	bangelijk	bevreesd	bangig	bezorgd	bang	zich zorgen makend
ankeren	teruggaan op	vastzetten
anomaal	afwijkend van de regel	afwijkend
arabier	turnoefening
arceren	inkleuren
artiest	kunstenaar
asperge	voorjaarsgroente	groente
associe	vennoot	compagnon
atrofie	afname van weefselmassa
aureool	kring rond een tepel	kring van licht	halo	stralenkrans van heiligen
autoped	speelgoed	step
avocado	groene vrucht	advocaatpeer	vrucht
badmuts	zwemaccessoire
bagatel	futiliteit	onbenulligheid	kleinigheid	niemendalletje
baktijd	onderdeel van recept
balatum	vloerbedekkingsmateriaal
bandiet	struikrover	boef	rover	overvaller	schurk	misdadiger
barbier	kapper die ook scheert	soort kapper
bariton	koperblaasinstrument	zangstem	lage zangstem
bassist	bandlid
bauxiet	mineraal
baviaan	grote aap
begonia	sierplant	tropische sierplant	scheefblad
beiaard	carillon
bekende	beroemdheid
benzine	brandstof	vloeibare brandstof
bewaker	lijfwacht	toezichthouder
biatlon	wedstrijd met twee onderdelen
biertje	drankje	pils	pintje	pilsje
bietsen	inpikken	stelen	aftroggelen	wegnemen
bigamie	dubbel huwelijk	dubbele echt
biljoen	groot getal	duizend keer een miljard	getal met twaalf nullen
bioloog	wetenschapper
bisjaar	schooljaar dat opnieuw wordt gedaan	doublurejaar
blieven	van iets houden	lusten	wensen
blogger	schrijver op het internet
blouson	modieus kledingstuk	windjack	sportieve, korte jas
bokking	gerookte haring
bolster	pantser	schil van kastanjes en noten
bombast	hoogdravende stijl
bongerd	boomgaard
bosmuis	klein zoogdier
bosnimf	mythologisch wezen	dryade
botanie	wetenschap	plantkunde
bottine	lage laars
bourree	Franse rondedans	dans
bouvier	ruw behaarde hond
breezer	mixdrankje
briefen	mondeling informeren	informeren
broeder	gelijkgezinde	kloosterling	frater	familielid	verpleger	ambulancier	monnik
brokaat	versierde stof
brokken	breken	in kleine stukjes breken
brommer	motorvoertuig	licht motorvoertuig	knorrepot	mopperaar
broodje	lunchgerecht
buizerd	roofvogel
bultrug	walvis	grote walvis
bunzing	klein zoogdier	soort marter
pastoor	hoofd van een parochie	geestelijke
variete	theatergenre
groente	voedingsmiddel	gewas
plateau	hoogvlakte	verhoging	verhoogd terras	platform
souffle	luchtig gerecht	luchtig ovengerecht
tamboer	trommelaar	miltaire trommelaar
soldaat	militair	krijgsman
myriade	tienduizendtal	menigte	ontelbare menigte
kanteel	bouwonderdeel	tinne	deel van een borstwering
pecunia	geld
monocle	oogglas
dreinen	drenzen	zeurend klinken	continu huilen en zeuren	dreunen
wasemen	blijk geven van
plevier	steltloper	vogel
lobelia	tuinplant
gehaaid	gewiekst	geslepen	sluw	leep
stokvis	gedroogde kabeljauw	consumptievis
updaten	actualiseren
imprint	drukkersmerk
kerkuil	roofvogel
jureren	beoordelen
kwabaal	zoetwaterkabeljauw
dupliek	antwoord op een repliek	antwoord
paddock	perceel
risotto	rondkorrelige rijst	rijstgerecht	Italiaans rijstgerecht
driegen	rijgen	losjes vastnaaien	losjes verbinden
spreeuw	gespikkelde vogel	vogelsoort
legging	elastische strakzittende broek
magnaat	zeer rijk zakenpersoon
viaduct	lange brug	brug
macadam	wegverharding	wegdek	wegdek van steenslag
martini	Italiaanse vermout	vermout
kapotje	regenjas
discant	rechterkant van het klavier	hoogste stem
witloof	stronkachtige groente	groente
maltees	taal
travers	kruiselings	zijgang	dwars
paprika	rode, gele of groene vrucht	groente
sextant	navigatie-instrument
tequila	Mexicaanse sterkedrank	sterkedrank
flinter	klein deeltje
wetsuit	rubber pak	surfpak
hutspot	samenraapsel	penenstamp	wortelstamp
thinner	verfverdunner	oplosmiddel
monarch	koningin	soeverein	vorst	oranje-zwarte dagvlinder	koning	vogel
concaaf	niet convex	holrond
tilapia	zoetwatervis	Afrikaanse zoetwatervis
hamster	knaagdier	klein huisdier
granaat	explosief projectiel	rode steensoort
zeepbel	kortdurende illusie	bubbel
cocotte	vuurvaste schaal	schaal
kropper	soort sierduif
kikvors	kikker
cineast	filmmaker	filmregisseur
facteur	bezorger	brievenbesteller	postbode	bode
stoppel	pas uitkomende vogelveer	kort haar	afgemaaide stengel
wurgnet	constrictor	beschermingsnet tegen granaten
seizoen	jaargetijde
noorman	Viking
kroelen	liefkozen en knuffelen
dadaist	irrationeel kunstenaar 	nihilist
saucijs	soort worst
snoeven	pochen	grootspreken	bluffen	opscheppen
peperen	kruiden	pikant maken
content	tevreden	voldaan
scherts	humor	gekheid
praline	bonbon
cruisen	ontspannen rijden	rijden voor het rijplezier
spitant	bruisend	wervelend	vitaal
compote	moes	grove vruchtenmoes met stukjes	vruchtenmoes
gerecht	maaltijd	justitie
klieren	etteren	klooien	vervelend doen
toestel	telefoon	vliegtuig	apparaat	werktuig
depeche	ambtelijke brief
rendier	soort hert
kombuis	keuken op een schip
giraffe	groot zoogdier	zoogdier met zeer lange nek
ochtend	deel van de dag	morgen
vampier	bloeddrinkende vleermuis	bloedzuigend wezen
sjekkie	sigaret	zelfgerolde sigaret
pleuren	stortregenen	pletteren	smijten
rettich	wortelknol	witte wortelknol
melasse	soort stroop
ovarium	vruchtbeginsel	eierstok
latrine	provisorisch wc	toilet
lazeren	neerstorten	vallen	smijten	gooien	tuimelen	werpen
kalmoes	zoete zegge	zwanenbrood	soort moerasplant
wachter	bewaker
parkiet	papegaaiachtige vogel
diadeem	hoofdsieraad
purisme	streven naar zuiverheid
uroloog	medisch specialist
termijn	periode
ex ante	voorafgaand	vooraf	van tevoren	tevoren
plengen	ritueel uitgieten	storten	gieten	uitgieten
collier	sieraad	ketting	halssnoer	halsketting
urinoir	soort toilet	plasbak
dolfijn	zeezoogdier
lambiek	Belgisch streekbier
camping	kampeerterrein
mustang	verwilderd paard
knotten	bomen inkorten	verminderen	bekorten	snoeien	kosten besparen	inkorten
cheddar	zuivelproduct	kaassoort
zittijd	examenperiode
convers	kloosterling	lekenbroeder
halfaap	zoogdier
epigram	puntdicht	gedicht	zeer kort gedicht	sneldicht
sangria	Spaanse drank
kolgans	wilde gans met witte kol	gans
diocees	bisdom
tartaar	gehakt rundvlees	gehakt
premier	eerste minister	regeringsleider	politicus
pompoen	grote vrucht
coltrui	kledingstuk
student	leerling
syllabe	lettergreep
smoking	kostuum	black tie	cravate noire	zwart kostuum
retabel	achterwand van een altaar
doublet	historisch jasje	duplicaat	twee gelijke woorden	team van twee	dubbele	bod bij bridge	dubbelworp	dubbel exemplaar	dubbel schot	edelsteenimitatie
penalty	strafworp	strafpunt	strafschop
troffel	metselaarsgereedschap
spindel	garenklos	as	spil	as van een draaitafel	klos
cycloop	eenoog	mythisch wezen
lasagne	Italiaans gerecht
kaaskop	Nederlander	Hollander
incisie	insnijding	snede
drummer	muzikant
oliebol	oudjaarssnack
klipper	zeilschip	slank zeilschip
franken	Germaans volk
fractal	complexe figuur
pompier	brandweerlid
lorgnet	pince-nez	neusknijper	knijpbril
station	stopplaats voor treinen	stopplaats
slufter	getijdengebied tussen duinen	opslagplaats voor slib
olifant	groot zoogdier
kooiker	hondenras
perspex	plexiglas
knoeier	fraudeur	oplichter	prutser
krauwen	krabben
schacht	koker	omhulsel	toegang tot een mijn	deel van een veer
lommerd	bank van lening	pandhuis
dweilen	moppen	schoonmaken	zwabberen
malheur	ellende	mankement	gebrek	ongeluk	voorval	rampspoed
eetlust	honger	appetijt	trek
vleugel	vliegorgaan	deel van een gebouw	grote piano	draagvlak van een vliegtuig
flessen	bedriegen	oplichten	afzetten
neglige	ochtendmantel	huisgewaad	nachtkleed	nachtjapon	huisjapon	nachthemd	ochtendkleed
tritium	waterstofisotoop
termiet	soort tropische mier	witte mier	insect
wrongel	kaasstof
knokkel	vingergewricht
lustrum	periode van vijf jaar
microbe	eencellige
octopus	achtarmig dier	weekdier
miswijn	wijn	wijn die in de mis wordt gebruikt
huismus	zangvogel	bruin-grijze zangvogel
caisson	duikerklok
schurft	plantenziekte	besmettelijke huidaandoening
paasdag	Christelijke feestadg
leenman	vazal
ragebol	borstel	spinborstel	onverzorgd kapsel
kanarie	kleine zangvogel
tjilpen	piepen als een vogel	fluiten
aannemer	leider van bouwwerkzaamheden
aanrecht	keukenmeubel
aanwezig	voorradig	tegenwoordig	present	voorhanden
aardmuis	zoogdier
aardworm	pier
abattoir	slachterij	slachthuis
abrikoos	vrucht	oranjegele steenvrucht	oranjegeel	fruit
absoluut	onbeperkt	met onbeperkte macht	stellig	helemaal	in elk geval	totaal	volstrekt	beslist	volslagen	zeker	per se	niet betrekkelijk	tegen elke prijs	geheel
abstract	conceptueel	non-figuratief	samenvatting	theoretisch	niet concreet
acrobaat	circusartiest
acroniem	letterwoord
addendum	bijlage	supplement	appendix	toevoegsel
adellijk	edel	nobel
ademloos	zeer stil	geboeid
adjudant	carnavalsfiguur	brandweerman	politieagent	onderofficier
admiraal	militair	generaal bij de marine
adviseur	consultant
advocaat	verdedigend jurist	eierlikeur
advocate	verdedigend jurist
afgezant	boodschapper	diplomaat
afzender	verstuurder
afzetter	iemand met te hoge prijzen
agrarier	boer
albanees	taal
albatros	grote zeevogel
algemeen	voor alle gevallen geldig	wijdverspreid	veelvoorkomend	wijdverbreid	gewoon	globaal
althoorn	koperen blaasinstrument	blaasinstrument
altviool	strijkinstrument
amarillo	goudgeel
amethist	violetkleurige edelsteen	edelsteen
ammoniet	fossiel weekdier
andijvie	bladgroente
anonymus	ongenoemde	onbekende
antilope	Afrikaans zoogdier
antipode	tegenvoeter	tegenovergestelde
apostrof	leesteken	weglatingsteken	afkappingsteken
apotheek	winkel voor medicijnen
apparaat	toestel	mechanisch toestel	werktuig
appetijt	eetlust	honger	trek
aquaduct	waterleiding	Romeinse waterleiding
aquarium	dierverblijf	visbak	visverblijf
arbeiden	zwaar werk doen	werken
arbeider	werknemer
artieste	kunstenares
assenaar	Drenth
asthenie	zwakte	krachteloosheid
atalanta	vlinder	admiraalvlinder
atoombom	kernwapen	kernsplijtingswapen	nucleair wapen
augustus	maand	oogstmaand	achtste maand
autogeen	vanzelf plaatsvindend
babyboom	geboortegolf na WO II	geboortegolf
babyface	kinderlijk gezicht
babyluik	vondelingenschuif
bachelor	academische graad	studie
bacterie	eencellig organisme	micro-organisme
badkamer	wasvertrek	vertrek
bakboord	linkerzijde van een schip	links
bakeliet	kunsthars	soort kunststof
bakkerij	broodverkoper
bangerik	angsthaas
barbecue	braadtoestel	kookgerei voor buiten
basilica	gebouw voor handel en rechtspraak	kerkgebouw
bastaard	gekruist dier	mengvorm	hond van gemengd ras	hybride	onwettig kind	buitenechtelijk kind
batikken	Indische verfmethode
bavarois	nagerecht	pudding	luchtige pudding
bediende	lakei	huisknecht
behoeder	beschermer
bejaarde	65-plusser	senior	oudere
belhamel	kwajongen	deugniet
benefiet	evenement voor het goede doel
bergamot	citrusvrucht	peervormige citrusvrucht
beroerte	hersenbloeding	herseninfarct
beschuit	rond baksel	krokant baksel
beunhaas	iemand met onvoldoende vakkennis
beverrat	knaagdier
bezieler	inspirator	iemand die iets tot leven wekt
bezoeker	gast	sporter die uit speelt
biefstuk	stuk gespierd rundvlees	goed spiervlees	stuk goed spiervlees	gespierd rundvlees
bierkaai	onoverwinlijke tegenstander
biggelen	omlaag druppelen
bikkelen	hard werken	hard spelen	hard strijden
biograaf	levensbeschrijver
bioscoop	filmhuis	filmtheater	plaats waar films worden vertoond	uitgaansgelegenheid
bisamrat	waterkonijn	muskusrat
bisschop	geestelijke	geestelijke in de katholieke kerk
bladluis	klein diertje op planten	insect
blessure	verwonding	kwetsuur
bloemist	plantenverkoper
bobbycam	minicamera in een politiehelm
boemelen	uitgaan en veel drinken
bohemien	onconventioneel kunstenaar
bolderen	donderen	rammelend voortbewegen	een rommelend geluid maken	denderen
bondsdag	Duits parlement
bootsman	leidinggevende van matrozen	onderofficier bij de marine
bordeaux	rode wijn	stad in Frankrijk
botanist	plantkundige
botbreuk	fractuur
boterham	lunchgerecht	sneetje
bouillon	aftreksel	dunne soep	aftreksel van vlees, groenten of vis
bouwwerk	constructie
brancard	draagbaar
broccoli	groene groente	groente
broderie	snoeiwerk	handborduurwerk	meetkundig snoeiwerk	borduurwerk
brombeer	mopperaar
bromelia	kamerplant	Zuid-Amerikaanse plant
bruinvis	kleine dolfijn
brunette	vrouw met donkerbruin haar
buffelen	ploeteren	zwoegen
bullebak	norse kerel
bungalow	vakantiewoning	vrijstaand woonhuis
landauer	vierwielig rijtuig
espresso	sterke koffie	koffie
zeebaars	vissoort
kameleon	reptiel	veranderlijk persoon	van kleur veranderend dier
salpeter	zout	muuruitslag
foefelen	knoeien	sjoemelen	rommelen
trombone	koperen blaasinstrument	blaasinstrument	bazuin
muzikant	kunstenaar
houtduif	grijze vogel
kwatrijn	vierregelige strofe
zebrapad	oversteekplaats
konkelen	roddelen	kwaadspreken
leefloon	uitkering	bestaansminimum	bijstand
glaciaal	ijstijdperk	ijstijd
machismo	stoer gedrag
steenbok	geit met grote horens	sterrenbeeld
spumante	mousserende wijn	schuimwijn
doelpunt	goal	treffer
dyslexie	woordblindheid	letterblindheid	leesblindheid
moutwijn	distillaat
dragline	graafmachine
couscous	soort griesmeel	Noord-Afrikaans gerecht
schoffel	landbouwwerktuig	tuingereedschap	landbouwmachine
scribent	schrijver
eclatant	stralend mooi	opvallend	overweldigend	opzienbarend
militair	persoon in het leger	van het leger
huppelen	dartelen	springend bewegen
esoterie	leer van het bovenzintuiglijke
fuselier	infanterist
hoogheid	verhevenheid	hoge adellijke
gentiaan	plant
pistolet	knapperig broodje	broodje
crucifix	kruisbeeld
telefoon	communicatiemiddel
ezelsoor	andoorn	omgevouwen hoekje	late veldsla	grijsgroene plant
dynastie	machtige familie	vorstenhuis	regeringsperiode
waterrat	goede zwemmer
lispelen	fluisteren
deugniet	kwajongen
tenderen	neigen	sterk lijken op	overhellen
diameter	middellijn
trappist	kloosterling	abdijbier	biersoort
sombrero	Mexicaanse hoed
megaliet	prehistorisch monument	reuzensteen
tsjilpen	piepen	piepen als een vogel	fluiten
entrepot	opslagplaats	pakhuis	opslagplaats van de douane
smeerlap	machtsmisbruiker	gemeen iemand	viezerik
trottoir	voetpad	oort	stoep
keyboard	toetsenbord	toetsenbord van een computer	klavierinstrument	klavier	elektronisch toetseninstrument
glaucoom	oogziekte	groene staar
fermette	woning in hoevestijl	woonboerderij
deukhoed	hoofddeksel
macaroni	soort pasta
verkoper	handelaar
tjiftjaf	kleine zangvogel
olympier	verheven persoon	god
etholoog	gedragswetenschapper
canaille	uitschot	janhagel	gemeen volk	gepeupel	volk	ordinair persoon	tuig
centeren	je innerlijke zelf zoeken
causerie	onderhoudende voordracht	praatje
dadelijk	onmiddellijk	subiet	direct	meteen	straks
hovenier	tuinier
lingerie	luxueus ondergoed
tabbaard	bovenkleed	nachtpon	gewaad van sinterklaas	nachtjapon	toga	nachthemd
miserere	boetepsalm
zondebok	iemand die de schuld krijgt
mangelen	verdrukken	wringen	ontbreken
matineus	vroeg in de dag
gangetje	smalle doorloop	langzaam tempo
homoniem	gelijkvormig woord
pierlala	mager, lang figuur	Magere Hein	figuur uit het poppentheater
shiitake	paddenstoel	eetbare paddestoel
eerdaags	weldra	spoedig	binnen afzienbare tijd	binnenkort	eerlang
zoologie	dierkunde
ringworm	schimmelinfectie
eekhoorn	knaagdier met pluimstaart
nautilus	inktvis met schelp	onderzeeër
duikboot	onderzeeër
zeurkous	zeveraar	zever
seminaar	studiedag
suppoost	museumbewaker
stichter	oprichter
rataplan	ongeordende massa	rommel	rotzooi	warboel	mikmak
rietvink	kleine vogelsoort	soort nachtvlinder
minnares	maîtresse	geliefde	buitenechtelijke geliefde
dejeuner	lunch	middagmaaltijd
mocassin	instapschoen
ligament	slotband
ceintuur	riem
minister	politicus
opticien	optometrist	brillenverkoper	brillenwinkel
maaltijd	voedsel	eten
weerwolf	fabelwezen
teerling	dobbelsteen
roerdomp	reigerachtige vogel
milicien	dienstplichtige
kneuzing	contusie	beschadiging van onderhuids weefsel	pletting	handeling	beschadiging	pletten
epitheel	dekweefsel
ijsberen	heen en weer lopen
selderij	groente
kapitein	aanvoerder	bevelhebber	gezagvoerder op zee
magister	novicenmeester	titel	godgeleerde	graad	leraar	middeleeuwse academicus
drumstel	slaginstrument
pleister	muurbekleding	substantie	plakker	verband	middel	verband met zelfklevend deel	lapmiddel	mengsel van gips en kalk	hulpmiddel
gisteren	de dag voor vandaag
demarche	onverwacht initiatief	initiatief
gluiperd	achterbaks persoon
husselen	schudden	mengen	dooreenhalen	dooreenschudden	dooreenmengen
ecclesia	volksvergadering in Athene	volksvergadering	christelijke geloofsgemeenschap
excretie	uitscheiding	afgescheiden stof
sojamelk	zuivelvervanger
linguist	taalkundige	taalwetenschapper	taalgeleerde
uitbaten	exploiteren
foeteren	mopperen
gelukkig	verheugd	fortuinlijk	blij	tevreden
predator	roofdier
mieteren	vallen	smijten	gooien	tuimelen	werpen
fandango	Spaanse volksdans	volksdans
geweldig	goed	magnifiek	formidabel	fantastisch
fenotype	verschijningsvorm
zinsbouw	frasering
uitsnede	detail van een afbeelding	fragment
kemphaan	vechtlustige trekvogel	ruziemaker	ruziezoeker
rugcrawl	zwemslag
warrelen	wemelen	door elkaar of heen en weer bewegen
clericus	geestelijke
chanteur	afperser	zanger	chansonnier
gnostiek	ketterse leer
schelvis	soort kabeljauw
goudvink	zangvogel
vaandrig	nog niet beëdigd officier	hulpleider bij de scouting
mansarde	dakkamer	vlieringkamer	zolderkamer	zadeldak
huisbaas	verhuurder
dictator	alleenheerser	heerszuchtig persoon	despoot	machtsbelust persoon
oneliner	kernachtige uitspraak
polygoon	veelhoek
coiffeur	kapper
strijder	krijger	voorvechter
limerick	vijfregelig puntdicht	korte dichtvorm
solarium	zonneterras	zonnebank
karekiet	zangvogel
toerisme	reizen ter ontspanning
kabouter	klein fabelwezen	klein fictief wezen	jonge scout
muildier	kruising van een ezel en een paard
aanbieder	provider
aangenaam	prettig	genoeglijk	plezierig	fijn	behaaglijk
aanhaling	citaat
aanhanger	voorstander	volgeling	medestander	supporter
aanstaand	toekomstig	eerstvolgend
aanvaller	voorhoedespeler
aardappel	patat	knol	pieper
abdicatie	troonsafstand
aberratie	afdwaling	afwijking
abnormaal	atypisch	ongewoon	afwijkend
abstinent	onthoudend
accordeon	toetseninstrument
achteloos	zonder aandacht
afgelegen	op grote afstand
afgelopen	voorbijgegaan	vorig	jongstleden	verleden
afkomstig	afgeleid	de oorsprong hebbend	daterend	afstammend
afrikaans	taal
afvalrace
afzuigkap	keukenapparaat
agrarisch	de landbouw betreffend
alleseter	omnivoor
alligator	reptiel	krokodilachtig reptiel
alpinopet	baret
alzheimer	ziekte
amaryllis	ridderster
ambassade	diplomatieke vertegenwoordiging
ambtenaar	overheidsdienaar
ambulance	ziekenauto	ziekenwagen
amerikaan	yankee
angsthaas	bangerik	schijtlijster	schijtlaars	schijter	bangerd	schijtluis	bangebroek	bangeschijter	schijterd
annuiteit	jaarlijks betaald bedrag	vast aflossingsbedrag
antiquaar	handelaar in oude boeken
antiquair	antiekhandelaar	antiekwinkel
apologeet	geloofsverdediger	verdediger van een gedachtegoed
apotheker	verkoper van medicijnen
appelflap	zoet gerecht
appelmoes	vruchtenproduct
appelsien	citrusvrucht
aprilgrap	seizoensgebonden humor
architect	bouwmeester	ontwerper van gebouwen
aspartaam	suikervervanger
assistent	hulpkracht	helper
assumptie	gedachte	veronderstelling
astroloog	sterrenwichelaar
astronaut	kosmonaut	Amerikaanse ruimtevaarder	ruimtevaarder
astronoom	sterrenkundige	wetenschapper
aubergine	dieppaars	groente	donkerpaarse vrucht	eierplant
autocraat	alleenheerser
autofocus	scherpstelsysteem	automatische scherpstelling
autotrein	trein voor personen én auto's
avondblad	soort krant
avondeten	maaltijd	diner
avondklok	straatverbod
badplaats	vakantieoord
balalaika	Russisch tokkelinstrument
baldakijn	overhuiving	luifel	overkapping in een interieur	overdekking boven een bed	afdak	overkapping
ballerina	lage damesschoen	danser
bandelier	draagband	draagriem
basgitaar	snaarinstrument
baspartij	lage noten in een muziekstuk
bedrieger	leugenaar	verlakker
beekforel	riviervis	zalmachtige vis
beresterk	onwankelbaar
berouwvol	spijtig
bevrijder	verlosser
bijenkorf	insectenbehuizing
bijtanken	met brandstof vullen	opladen	navullen
bijzitter	bijrechter	assessor	assessor in een bestuur	ondersteunende raadsheer	bijrijder	surveillant bij een eindexamen
billboard	reclamebord	groot reclamebord
binnenzee	omsloten water
bitterbal	warme lekkernij	gefrituurde lekkernij
bladgroen	chlorofyline	gebladerte	chlorofyl	loof
blasfemie	godslastering
blauwhelm	militair bij de VN
bloemkool	witte groente
blokfluit	houten blaasinstrument
boeddhist	gelovige
boezeroen	korte kiel
bolderkar	handwagen
bolvormig	rond
bombardon	helicon	groot koperen blaasinstrument
borsalino	deukhoed
botanicus	plantkundige
botanisch	plantkundig	gekweekt
boterkoek	koffiebroodje	koffiebroodje van bladerdeeg
bourgogne	Franse wijnstreek	wijnstreek
bovenhuis	etagewoning
brandweer	overheidsdienst
brigadier	miltaire rang	politierang
bromfiets	licht motorvoertuig	tweewielig motorvoertuig
bromvlieg	insect
bronchien	luchtpijpvertakkingen
bronstijd	prehistorische periode
bruidegom	verloofde	man op zijn trouwdag	aanstaande echtgenoot
bucolisch	landelijk	rustiek	arcadisch	pastoraal	herderlijk
schaamlap	te klein excuus	verdoezeling
wethouder	gemeentebestuurder
welgezind	goedgehumeurd
chihuahua	kleine hond
triniteit	drievuldigheid	drie-eenheid
zeestraat	doorgang
paillette	lovertje	glinsterende versiering
kidnappen	ontvoeren
tricolore	driekleurig	driekleur
indertijd	toen	vroeger
mitigeren	matigen	afzwakken	verzachten
flashback	terugblik
geelbruin	kleur
vogelkooi	volière	muit
pantomime	gebarenspel
procureur	openbaar aanklager
houwitser	stuk geschut met korte loop
valkenier	vogelhouder
zeevrucht	weekdier	schelpdier
stokbrood	langwerpig deegwaar	Frans deegwaar
etiologie	leer van ziekteoorzaken	oorzaken van aandoening	leer van oorzaken
uithollen	leeg maken	uitdiepen
spitsmuis	klein zoogdier	insectenetend zoogdier
zesjarige	kleuter
donsdeken	dekbed
kappertje	glaasje op een voetje
pepermunt	geurige plant	snoepje
professor	hoogleraar	geleerde
predikant	priester	imam	dominee
vogelspin	grote, behaarde spin
wielewaal	geel-zwarte zangvogel	zangvogel
flipperen	inbreken	inbreken met een kaartje
mechelaar	hondenras	soort herdershond
chlorofyl	bladgroen
percussie	slagwerk
dystrofie	aandoening aan weefsel
cyclotron	deeltjesversneller
oncologie	medisch specialisme
knuppelen	doodslaan
memoriaal	herinneringsmonument	gedenkteken	herdenkingsmonument	boek met feiten	monument	koopmansboek	herinneringsteken	gedenkplaats
schaatser	wintersporter
directeur	manager	CEO	leider van een organisatie
springbok	soort antilope
lambrusco	Italiaanse wijnsoort
conserven	ingemaakt voedsel
vlinderen	fladderen	een betonvloer afwerken	dartelen	afwerken
radioloog	medisch specialist
retriever	soort hond
stiefelen	hard lopen
opstropen	omhoog schuiven
veelvraat	groot marterachtig zoogdier	hongerlap	slokop
hypotheek	lening
visceraal	diepgeworteld	zonder consideratie	aan de ingewanden
courgette	groente die lijkt op een komkommer	groene groente	groente
logaritme	rekenkundige bewerking	exponent in rekenkunde
vleermuis	vliegend zoogdier
waarnemer	toehoorder	observeerder	beschouwer
mandoline	tokkelinstrument	keukenschaaf
hoepelrok	victoriaanse onderkleding	crinoline
pleonasme	stijlfiguur
maatschap	samenwerkingsvorm
deduceren	afleiden
concierge	huisbewaarder
internist	medisch specialist
voegwoord	conjunctie
zonnehoed	plant met grote bloemen
kletskoek	gepraat
pneumonie	longontsteking
gnostisch	geestelijk
intoneren	uitdrukken	een klankkleur geven	een juiste toon vormen
welmenend	oprecht
korenwolf	hamster	veldhamster	zwartbuikhamster	wilde hamster	gewone hamster
ordonnans	militaire boodschapper
nieuwjaar	feestdag
gyroscoop	tolkompas
hooiwagen	langpootmug
steunbeer	pijler	stut voor een muur	contrefort
ethologie	gedragsleer
diligence	koets	postkoets
geriatrie	medisch specialisme voor ouderdomsziekten
heenmatch	uitwedstrijd
existeren	bestaan	zijn
congruent	overeenkomend	overeenstemmend
platbodem	type boot
tijdelijk	voorbijgaand	niet-definitief	vergankelijk
wichelaar	waarzegger
discretie	vermogen tot onderscheid	plicht tot geheimhouding
carbonaat	koolzuurzout
kliederen	slordig schrijven	knoeien	morsen
vliegveld	luchthaven
grafoloog	schriftkundige
nijlbaars	Afrikaanse zoetwatervis
usurpator	overweldiger
sfeerloos	ongezellig	saai
pantseren	zich beschermen	iets met staal bekleden	zich wapenen
portofoon	walkietalkie
confituur	jam	broodbeleg	zoet broodbeleg van vruchten
kerselaar	kriekelaar	hout	boom
fungicide	bestrijdingsmiddel	schimmeldodend middel
dalmatier	hond met gevlekte vacht
leeuwerik	kleine zangvogel
contrabas	zangstem	lage zangstem	lage saxofoon	laagste strijkinstrument
sluipwesp	insect
earl grey	theesoort
zebravink	vogel met zwart-witte staart
ontdekker	uitvinder
cantharel	eetbare paddenstoel
harmonium	soort huisorgel
gingerale	frisdrank
champagne	schuimwijn
wijngaard	soort akker
pastinaak	witte wortel	witte peen
kangoeroe	buideldier uit Australië
roodkapje	sprookjesfiguur
robbedoes	wildebras
palaveren	langdurige besprekingen voeren
dubbeltje	tien cent	muntje van tien cent
aandachtig	oplettend	geconcentreerd	opmerkzaam	belangstellend
aandrijven	de sporen geven
aangebrand	verschroeid
aansnoeren	strak vastmaken
aanvoerder	koploper	leider van een sportteam	kapitein	hoogst genoteerde sporter	toonaangevend persoon
aanvullend	bijkomend	supplementair	extra	complementair
abiturient	schoolverlater
aboriginal	inheemse Australiër
absurdisme	filosofie	kunststroming
academisch	wetenschappelijk	universitair	theoretisch	abstract
acceptabel	aanvaardbaar
accountant	financieel expert	boekhouder
achterlijk	dom	belachelijk	idioot	stompzinnig
afspanning	omheining
agnostisch	niet wetend of God bestaat
alcoholist	verslaafde
alpenhoorn	blaasinstrument
amanuensis	technische assistent	technisch onderwijsassistent
anglicisme	Engels taalelement	barbarisme
annonceren	bekendmaken	adverteren	aandienen	aankondigen
appeltaart	soort gebak
aquamarijn	blauwgroen mineraal	edelsteen	blauwgroen	blauwgroene edelsteen	edelgesteente
archeoloog	oudheidkundige
architraaf	omlijsting van een kozijn
armageddon	strijd	allesvernietigende oorlog
assistente	hulpracht
assuradeur	verzekeraar	verzekeringsmaatschappij
assurantie	verzekering	vakgebied van verzekeren	verzekeringsmaatschappij
astrologie	leer van de invloed van hemellichamen	sterrenwichelarij
astronomie	wetenschappelijk vakgebied	sterrenkunde
avonturier	fortuinzoeker	gelukzoeker	ontdekkingsreiziger
babyboomer	iemand geboren vlak na WO II
bacchanaal	drinkgelag	drinkpartij
backgammon	bordspel	bordspel in een koffer
barbarisme	onzuiver taalelement
barbecueen	roosteren
bedenktijd	reflectietermijn
bedilzucht	bemoeizucht
beenhouwer	slagerswinkel	slagerij	slager
begeleider	hulpverlener	escorte	ondersteuner	coach
bekermatch	wedstrijd
belladonna	plant met medische toepassing	wolfskers
bellefleur	appelsoort
bellettrie	letterkunde	schone letteren	literatuur	letterkundige werken
beschermer	behoeder	begunstiger
betoelagen	subsidiëren
bibliofiel	liefhebber van boeken	boekenliefhebber
bibliomaan	bezeten door de liefde voor boeken	boekengek
bierviltje	onderzetter
bijenteelt	apicultuur
blancheren	kort opkoken
blauwgroen	groen
blikopener	wat tot nieuw inzicht brengt
bloemlezer	samensteller	anthologist
bodywarmer	warm mouwloos jasje
boekenwurm	papieretend insect	iemand die veel leest
boerenkool	krulkool	warm gerecht	groente
boogscheut	kleine afstand	steenworp
boosdoener	schuldige
borstcrawl	zwemslag	zwemstijl	vrije slag
bosanemoon	wit bloemetje in het bos
boswachter	natuurbeheerder
bottleneck	versmalling	knelpunt	vernauwing
bouwvakker	arbeider
brandewijn	sterkedrank
brommobiel	45 kilometerwagen
bronsttijd	paarperiode
buideldier	zoogdier met twee baarmoeders
chartreuse	likeur
handschoen	winterkleding	kledingstuk
illegitiem	onrechtmatig	onecht	onechtelijk	onwettig	wederrechtelijk	buitenechtelijk
cyclocross	veldrit	wielerwedstrijd	wielersport	veldrijden
woonplaats	gemeente	habitat	biotoop	leefgebied
volwassene	meerderjarige
librettist	schrijver van operateksten
ratelslang
psychiater	medisch specialist
vierjarige	kleuter
rokkostuum	zwaluwstaart	formele kleding
finishlijn	eindstreep
goedgevuld	rijkelijk voorzien	dik
perequatie	herschatting	herijking	herziening	verandering
tetralogie	reeks van vier werken	hartafwijking	drie drama's en een saterspel	viervoudige hartafwijking
tafelkleed	eetdoek
malariamug	stekend insect
mint julep	cocktail
frietkraam	snackbar
zonnesteek	hitteberoerte
voorzitter	president	preses
spelleider	scheidsrechter
delinquent	crimineel	misdadiger
gemberbier	frisdrank
krentenbol	broodje
welbesteed	nuttig doorgebracht
peterselie	kruid	soepgroente
geneesheer	heelmeester	dokter	arts
nivelleren	verschillen kleiner maken	gelijkmaken	effenen	afvlakken	vlakmaken	een achterstand inlopen	egaliseren
rijnlander	soort wijn	kippenras	konijnenras	soort vrachtschip	paardenras
diabeticus	suikerlijder
leerschool	bron van kennis
hippodroom	paardenrenbaan
diabolisch	duivels	demonisch
ontsteking	inflammatie
cytoplasma	deel van een cel
mechanicus	werktuigkundige	monteur
cardioloog	hartspecialist
pompelmoes	grote, gele citrusvrucht	grapefruit	citrusvrucht
ijsbergsla	bladbroente
historicus	geschiedschrijver	geschiedkundige
pasteltint	lichte kleur
misdadiger	delinquent	crimineel
oorsuizing	spookgeluid	fantoomgeluid
nachtegaal	zangvogel	iemand die mooi zingt
winterhard	bestand tegen koude
distelvink	putter	vogelsoort	vlindersoort
hydrologie	studie van water
toehoorder	luisteraar
misantroop	mensenhater
moordenaar	griptang	misdadiger
deskundige	expert	specialist
goochelaar	illusionist
champignon	paddenstoel	eetbare paddenstoel	kampernoelie	kampernoelje
chagrijnig	humeurig	sikkeneurig	misnoegd	nors	slechtgehumeurd	slechtgezind	knorrig
voluptueus	groot	weelderig	mollig	wellustig	wulps
immigreren	zich komen vestigen	verhuizen
tendinitis	peesontsteking
permafrost	altijd bevroren bodem
stalagmiet	druipsteen
seminarium	werkcollege	geestelijke onderwijsinstelling	studiedag	vakgroep	college
directoire	vroegere Franse regering	neoclassicistische stijl
wisselslag	wedstrijdcategorie bij zwemmen
panopticum	wassenbeeldenmuseum	cirkelvormige gevangenis
supermarkt	zelfbedieningswinkel	winkel
chimpansee	mensaap
reparateur	hersteller
overledene	gestorvene
hydraulica	wetenschap van water en andere vloeistoffen
trenchcoat	regenjas	militaire regenjas
homeostase	zelfregulatie
reclameren	klagen	genoegdoening vragen
strychnine	zeer giftige stof
slechtvalk	roofvogel
secretaire	schrijfmeubel
sanseveria	sierplant	kamerplant	vrouwentongen
tijdspanne	begrensde periode	periode
undercover	een valse identiteit aannemend
crediteren	een bedrag bijschrijven	iemands rol erkennen
kikkererwt	ingrediënt in hummus	groente
vergeetput	onderaardse kerker	kerker	obliëtte
wegenwacht	pechhulpdienst
jeremieren	jammeren	lamenteren	weeklagen	klagen
schouwburg	theatergebouw
gierzwaluw	vogel
sprankelen	uitblinken	stralen	schitteren
hooglander	rund
pejoratief	ongunstige benaming	afkeurend
kaartlezer	waarzegger
gallicisme	Frans taalelement
entomoloog	insectenkundige
exploitant	instantie	instelling	uitbater	gerant
trekschuit	door paarden getrokken boot
aalscholver	zwarte watervogel
aantekening	korte notitie	vermelding	bedenking	noot	annotatie	schriftelijke opmerking
aanvangsuur	begintijd
aanzienlijk	belangrijk	vrij groot
aardbewoner	mens
aardedonker	totale duisternis
abracadabra	hocus pocus	toverspreuk	onbegrijpelijke taal
abstinentie	onthouding
accidenteel	bijkomstig	toevallig	per ongeluk
advertentie	reclame
afborstelen	schoonmaken
affirmatief	bevestigend	bevestiging	akkoord	bekrachtigend
afhankelijk	onzelfstandig
afrikaantje	sierplant	tuinplant
afwisselend	om de beurt	om en om	omstebeurt	gevarieerd	beurtelings
alexandrijn	versregel van zes jamben	soort dichtregel
ambassadeur	vertegenwoordiger	ambtenaar	diplomaat	afgezant
anesthesist	arts-specialist voor narcoses	arts
angstgegner	gevreesde tegenstander
antipapisme	negatieve houding tegen de katholieke kerk
antropogeen	van menselijke oorsprong
antropomorf	mensachtig	vermenselijkt
apodictisch	onweerlegbaar	met stelligheid geponeerd
appartement	woning	flat
aquacultuur	het kweken van vis
bedevaarder	pelgrim
beeldhouwer	kunstenaar
behandelaar	therapeut
benedictijn	kloosterling	lid van kloosterorde
beoordelaar	criticus
besnuffelen	onderzoeken
betoelaging	subsidie
bewaarengel	beschermer
bibliofilie	boekverzameling	liefde voor bijzondere boeken	boekenliefhebberij
bibliotheek	instelling voor boeken	verzameling raadpleegbare documenten
biljartclub	sportvereniging
binnenschip	rivierboot
bissectrice	deellijn door het hoekmidden
blasfemisch	godslasterlijk
bleekscheet	iemand met een lichte huid
bloedzuiger	ringworm	parasiet	vampier
bloody mary	cocktail van wodka
bollenteelt	soort landbouw
bolsjewisme	leninisme	communistische doctrine
boomkruiper	klein vogeltje
boskabouter	wezen uit kinderboeken	mythologisch wezen
bourgondier	levensgenieter
bouwmeester	architect
brouilleren	vertroebelen	in onmin raken	verstoren
brugklasser	scholier
brugperiode	oriëntatietijd
buikspreker	gastriloog	ventriloquist
rooskleurig	hoopvol	optimistisch	veelbelovend	gunstig
satisfactie	tevredenheid	voldaanheid	genoegdoening	voldoening	bevrediging	vergenoegdheid
slakkenhuis	spiraalvormige gang in het oor	schelp	binnenoor
hagiografie	beschrijving van heiligenlevens
goedemiddag	groet
mathematica	wiskunde
ochtendblad	krant
rechercheur	politieonderzoeker
hartinfarct	hartaanval
whisky sour	cocktail
ziekenwagen	ambulance
goedgeluimd	welgezind
zaakvoerder	filiaalchef	bedrijfsleider
langpootmug	glazenmaker	hooiwagen
polemologie	studie van de oorlog
okerkleurig	donkergeel
hoogvlieger	tamme duif	begaafd persoon
dobbelsteen	teerling
sinaasappel	oranje citrusvrucht	citrusvrucht	appelsien	oranjeappel
stethoscoop	doktersinstrument
polikliniek	spreekuur
schoorsteen	rookafvoer	schouw
veelkleurig	afwisselend	divers
scenografie	decorontwerp
parastataal	semiautonoom
lexicologie	woordenleer
scholekster	vogelsoort	bonte piet
goedemorgen	groet
inauguratie	intrede als hoogleraar	inhuldiging	intrede in een ambt
kosmopoliet	wereldburger
spierbundel	krachtpatser	dommekracht	hulk
formatteren	structureren	een computerschijf indelen
degeneratie	verslechtering	artrose	kwaliteitsverlies	slijtage	neergang	ontaarding
meestergast	onderbaas
presentator	nieuwslezer
hoogseizoen	drukste periode
decorbouwer	scenograaf
klavecimbel	toetseninstrument
kweekschool	pedagogische academie	pabo
regenscherm	paraplu
potsenmaker	slechte acteur
ultramarijn	bergblauw	helderblauw	blauwe kleur
overdrijven	zich verplaatsen	te veel doen	zich verwijderen	overtrekken	4.0 - tot verplaatsing dwingen	te groot voorstellen	verdwijnen	doorslaan	overgaan	wegtrekken
stekelbaars	soort vis
congenitaal	aangeboren
wichelroede	instrument voor waarzeggerij
gendarmerie	politie naar militair voorbeeld	politie
haatdragend	rancuneus	onverzoenlijk
contribuant	bijdrager
ongemanierd	onbeleefd	onfatsoenlijk	onnet
hersteltijd	tijd nodig om iets te repareren	tijd	tijd nodig om te genezen	tijd nodig om uit te rusten
elektrolyse	chemische ontleding
menswaardig	humaan
onbestendig	wispelturig	instabiel	wisselvallig	onstandvastig	veranderlijk
pelargonium	verzameling	orde	geranium	kuipplant met rode e.d. bloemen	plant	groep
voorseizoen	toeristische periode
pepermuntje	snoepje
zaalwachter	suppoost
thermoplast	kunststof dat zacht wordt bij verhitting	type kunststof
gesoigneerd	netjes	verzorgd
mineralogie	delfstofkunde
aangehoudene	arrestant
aangeslotene	lid	abonnee
aankomstlijn	eindmeet	eindstreep
aanvaardbaar	acceptabel
aanvankelijk	eerst	in eerste instantie
accordeonist	muzikant
afgrijselijk	verschrikkelijk lelijk	afschuwelijk
afrodisiacum	lustopwekkend middel	lustopwekker
afschuwelijk	verschrikkelijk lelijk	afzichtelijk	afgrijselijk
afzichtelijk	onooglijk	verschrikkelijk lelijk	verschrikkelijk	weerzinwekkend	lelijk	afschuwwekkend	wanstaltig	afschuwelijk	vreselijk	afgrijselijk
afzonderlijk	op zichzelf beschouwd	los	eigen	separaat	opzichzelfstaand	individueel	apart
alvleesklier	orgaan	pancreas
ambassadrice	vertegenwoordiger	ambtenaar	afgezant
antwerpenaar	belg
appelbeignet	gefrituurd gerecht
appendicitis	blindedarmontsteking
automobilist	bestuurder	chauffeur
bananenschil	glad fruitrestant
bedrijfsarts	arbeidsgeneesheer
bedrijfsauto	firmawagen
beenhouwerij	slagerswinkel	slagerij	slager
bergafwaarts	omlaag	naar een lager niveau
bergopwaarts	omhoog	naar een hoger niveau
berichtgever	journalist	correspondent
bestemmeling	geadresseerde
betaalkracht	geldwaarde van een munteenheid
bijziendheid	zichtaandoening	myopie
bodemmonster	hoeveelheid aarde voor onderzoek
bodybuilding	krachtsport voor lichaamsontwikkeling
boezemvriend	hechte relatie
bontgekleurd	veelsoortig	uiteenlopend	verschillend
boodschapper	verkondiger	aankondiger	berichtgever	bode
boogschutter	sterrenbeeld	astrologisch teken
borstvoeding	moedermelk
bovenmeester	hoofdonderwijzer
breedsprakig	gedetailleerd	langdradig	lang van stof	uitvoerig	omslachtig
brokkenmaker	onhandig persoon
brontosaurus	uitgestorven reptiel met lange hals
broodrooster	toaster
buitenwipper	portier	uitsmijter
burgeroorlog	interne strijd
dijenkletser	goede grap
oefenmeester	trainer	coach
wereldburger	aardbewoner	kosmopoliet
circusnummer	optreden
caleidoscoop	mengeling	bonte mengeling
landverrader	collaborateur
einzelganger	eenzaat	individualist
tetracycline	antibioticum
dermatologie	tak van de geneeskunde
granaatappel	vrucht met eetbare rode pitjes
transpositie	omzetting	overbrenging
groenteteelt	soort landbouw
toneelspeler	acteur
postscriptum	naschrift
gouvernement	regering	overheid	provinciebestuur
ivoorkleurig	geelwit
eendagsvlieg	kortstondig verschijnsel	kort levend insect
rekenmeester	financieel deskundige
sterrenkunde	astronomie
wegenwachter	pechverhelper
megalithisch	uit grote stenen bestaand
cheeseburger	vleesgerecht
voedingsstof	deel	nutriënt
catechisatie	godsdienstonderwijs	protestants godsdienstonderwijs
wachtmeester	politieagent	politiefunctionaris	onderofficier
verslaggever	journalist	reporter
functionaris	ambtenaar
gelukszoeker	avonturier
gehandicapte	mindervalide
waterpistool	speelgoed
milliseconde	tijdseenheid
oceanografie	zeekunde
zeekomkommer	dier
uitentreuren	tot in het oneindige	tot vervelens toe	steeds maar weer	steeds  weer	eindeloos	telkens weer
aantrekkelijk	verleidelijk
abnormaliteit	afwijking
achterdochtig	argwanend	wantrouwig	wantrouwend
achtervoegsel	woorddeel	suffix
afgevaardigde	vertegenwoordiger	gezant	belangenbehartiger
beeldhouwster	kunstenares
bejaardenhuis	ouderenwoning 
beroepsspeler	professionele sporter	professionele acteur
bidsprinkhaan	insect
bisschopswijn	warme, gekruide wijn
blue hawaiian	cocktail van witte rum
brandstichter	misdadiger
bruggenbouwer	verzoener
reductionisme	filosofische opvatting
strottenhoofd	larynx
traumatologie	ongevallenafdeling
kwartiermaker	militair	wegbereider
mondharmonica	klein blaasinstrument	blaasinstrument
endocrinoloog	hormoonarts	medisch specialist
tranquillizer	kalmeringsmiddel
impressionist	soort kunstenaar
ruimtevaarder	kosmonaut	astronaut
modderkruiper	karperachtige visje
geadresseerde	bestemmeling
rijwielhandel	fietsenzaak	fietsenmaker	fietsenwinkel
doktersattest	verklaring van een arts
entertainment	amusement	vermaak
contrabassist	muzikant
tijdelijkheid	niet definitief zijn
gruzelementen	splinters	scherven	stukjes
verstoppertje	spel
gedenkwaardig	memorabel
nieuwjaarsdag	feestdag
collectioneur	verzamelaar
klastitularis	vaste leerkracht
doktersrecept	voorschrift van een arts
doorgewinterd	ervaren
epidemiologie	statistische ziektenleer	tak van de wetenschap
onbekwaamheid	ongeschiktheid
troonsafstand	abdicatie
paleontologie	wetenschap	studie van fossielen
striptekenaar	kunstenaar
kattebelletje	kort briefje	snel telefoontje
wielertoerist	iemand die afreist om te fietsen
paradepaardje	pronkstuk
dubbelportret	beschrijving van twee personen
recapituleren	samenvatten
gebrouilleerd	in onmin levend
chocolademelk	drank
wienermelange	koffie met melk en melkschuim	koffiedrank
samenzweerder	geheime bondgenoot	complotteur
structuurloos	chaotisch
verloskundige	vroedvrouw	arts	obstetricus	medisch specialist
godslastering	blasfemie
chateaubriand	biefstuk van de haas
white russian	cocktail
vliegenvanger	kleine zangvogel
kameleontisch	onstandvastig	veranderlijk
theaterschool	kunstopleiding
voorbijganger	passant
percussionist	slagwerker
komkommertijd	periode met weinig activiteit
veldleeuwerik	grijsbruine zangvogel
wijnbereiding	vinificatie
schoondochter	aangetrouwd familielid	familielid
ochtendgloren	dageraad	morgenstond
fijnschrijver	soort pen
hongerstaking	vorm van protest
goedgehumeurd	welgezind
meerderjarige	volwassene
hallucinogeen	geestverruimend middel	psychedelisch	geestverruimend
